0 5 4 1 3 4
5 0 2 3 2 2
4 2 0 1 2 4
1 3 1 0 3 3
3 2 2 3 0 1
4 2 4 3 1 0
